8,6,
w,w,w,w,w,w,w,w,
w,p,w,f,f,f,f,w,
w,f,w,w,sd,p,c,w,
w,f,w,w,w,dc,w,w,
w,f,f,f,f,f,m,w,
w,w,w,w,w,w,w,w